20 Floyd	B.	McKissick	Jr. McKissick D Strong	Democratic
38 Joel	Ford Ford D Strong Democratic
37 Jeff	Jackson J.	Jackson D Strong	Democratic
28 Gladys	A.	Robinson Robinson D Strong	Democratic
40 Joyce	Waddell Waddell D Strong	Democratic
32 Paul	Lowe Lowe D Strong	Democratic
14 Daniel	T.		Blue	Jr.	(Dan) Blue D Strong	Democratic
15 Jay	Chaudhuri Chaudhuri D Strong	Democratic
21 Robert	B.		Clark,	III	(Ben) Clark D Strong	Democratic
23 Valerie	P.	Foushee Foushee D Strong	Democratic
4 Open Open Strong	Democratic
22 Mike	Woodard	(Mike) Woodard D Strong	Democratic
49 Terry	Van	Duyn Van	Duyn D Strong	Democratic
16 Open Open Strong	Democratic
3 Erica	Smith Smith D Strong	Democratic
5 Don	Davis D.	Davis D Lean	Democratic
13 Danny	Earl	Britt	Jr. Britt R Competitive
19 Wesley	Meredith Meredith R Competitive
41 Jeff	Tarte Tarte R Competitive
1 Open Open Competitive
9 Michael	Lee Lee R Competitive
25 Tom	McInnis McInnis R Competitive
7 Louis	Pate Pate,	Jr R Competitive
18 John	M.	Alexander,	Jr. Alexander R Lean	Republican
17 Tamara	Barringer Barringer R Lean	Republican
27 Trudy	Wade Wade R Lean	Republican
24 Rick	Gunn Gunn R Lean	Republican
11 Rick	Horner Horner R Lean	Republican
10 Brent	Jackson B.	Jackson R Lean	Republican
12 Open	(Rabin) Open	(Rabin) R Lean	Republican
8 William	Rabon	(Bill) Rabon R Lean	Republican
39 Dan	Bishop Bishop R Strong	Republican
48 Chuck	Edwards Edwards R Strong	Republican
50 Jim Davis J.	Davis R Strong	Republican
36 Paul.	R.	Newton Newton R Strong	Republican
2 Norman	W.	Sanderson Sanderson R Strong	Republican
30 Phillip	Berger	(Phil) Berger R Strong	Republican
6 Harry	Brown Brown R Strong	Republican
47 Ralph	E.	Hise Hise R Strong	Republican
45 Shirley Randleman	&	Deanna	Ballard Randleman	&	Ballard R Strong	Republican
26 Jerry	W.	Tillman Tillman R Strong	Republican
43 Kathy	Harrington Harrington R Strong	Republican
44 David	L.	Curtis Curtis R Strong	Republican
31 Joyce	Krawiec	&	Dan	Barrett Krawiec	&	Barrett R Strong	Republican
33 Open Open Strong	Republican
46 Warren	Daniel Daniel R Strong	Republican
35 Open	(Tucker) Open	(Tucker) R Strong	Republican
42 Andy	Wells Wells R Strong	Republican
34 Open Open Strong	Republican
29 Open	(Dunn) Open	(Dunn) R Strong	Republican